M48
INCH,TZ
T1C0.012
T2C0.040
%
G90
G05
T1
X051050Y-034600
X051300Y-044250
X051300Y-045800
X051300Y-047250
X051300Y-048500
X052450Y-048700
X052700Y-045050
X052900Y-034600
X053950Y-045050
X054800Y-034600
X055050Y-037500
X055900Y-038350
X055900Y-039850
X055900Y-041050
X055950Y-048050
X056000Y-050900
X056500Y-035450
X056900Y-048050
X056900Y-050900
X057800Y-041050
X057850Y-048050
X057850Y-050900
X058000Y-043100
X058000Y-044400
X058000Y-044900
X058700Y-048050
X058700Y-050900
X058750Y-042400
X058750Y-043400
X058750Y-044350
X058750Y-045600
X059150Y-043900
X059500Y-050900
X059550Y-048050
X059600Y-043100
X059600Y-044400
X059600Y-044900
X059700Y-036700
X060800Y-044100
X060900Y-036700
X061900Y-051650
X062300Y-036700
X062800Y-052100
X063100Y-049500
X063250Y-037850
X063600Y-036750
X064900Y-042900
X064900Y-043650
X064900Y-044600
X064900Y-050900
X064950Y-035850
T2
X051100Y-053300
X052100Y-053300
X053100Y-053300
X054100Y-053300
X055100Y-053300
X056100Y-053300
X057100Y-053300
X058100Y-034300
X058100Y-053300
X059100Y-034300
X060100Y-034300
X060100Y-053300
X061100Y-034300
X061100Y-053300
X062100Y-034300
X062100Y-053300
X063100Y-034300
X063100Y-053300
X064100Y-034300
X064100Y-053300
X065100Y-034300
X065100Y-053300
T0
M30
